tileset = Sacaean1.png
map =    !@123..#.!@
         ..456.....!
         ..789......
         ...........
         ...........
         ...........
         ...........
         q..........
         a........#.
         z.#.......?
